14,16
1811111111111111
1000000120003001
1011112101110101
1300010101010101
1011011101010101
1001200000010101
1111111111010101
1000020000010101
1011101111110101
1015101231000111
1310031120010021
1011101101111111
1021200106000079
1111111111111111

